-----------------------------------------------------------------------------------------------------------------------------------------------------------------------------------------------------------------
-----------------------------------------------------------------------------------------------------------------------------------------------------------------------------------------------------------------
-----------------------------------------------------------------------------------------------------------------------------------------------------------------------------------------------------------------
------------------------------------------------------------------------------------------------------------------------------------------------------------------------------------------------------|----------
----------------------------------------------------------------------------------g-------------------------------------------------------------------------------------------------------------------|----------
----------------------?---------------------------------------------------------BBBBBBBB---BBB?--------------M-----------BBB----B??B--------------------------------------------------------##--------|----------
-------------------------------------------------------------------------------------------------------------------------------------------------------------------------------------------###--------|----------
-------------------------------------------------------------------------------g----------------------------------------------------------------------------------------------------------####--------|----------
----------------------------------------------------------------+------------------------------------------------------------------------------------------------------------------------#####--------|----------
----------------?---BMB?B---------------------[]---------{]------------------BMB--------------O-----B*----?--?--?-----B----------BB------#--#----------##--#-------R----BB?B------------######--------|-----XXX--
--------------------------------------[]------pP---------pP-----------------------------------------------------------------------------##--##--------###--##------R-------------------#######--------|-----XXX--
----------------------------[]--------pP------pP---------pP----------------------------------------------------------------------------###--###------####--###-----[]--------------[]-########--------|----XXxXX-
---------------------g------eE--------eE-g----eE-----gg--eE------------------------------------gg---------k-----------------gg-gg-----####--####----#####--####----eE---------gg---eE#########--------#----XXxXX-
#####################################################################--###############---################################################################--######################################################
