--Q-------------
--Q-------------
B---BBBBBBB----p
B--------------p
B--------------p
B----ccccc-----p
B--------------p
B---ccccccc----p
B--------------p
B---ccccccc----p
B---BBBBBBB----p
B---BBBBBBB--)HF
B---BBBBBBB-->hf
################
