------------------------------
------------------------------
------------------------------
-------------------|----------
-------------------|----------
---------##--------|----------
--------###--------|----------
-------####--------|----------
------#####--------|----------
R----######--------|-----XXX--
R---#######--------|-----XXX--
[]-########--------|----XXxXX-
eE#########--------#----XXxXX-
##############################
