---------------------------------------------------------------------------------------------------------------------------------------------------------------------------
---------------------------------------------------------------------------------------------------------------------------------------------------------------------------
B-----BBBBBBBBBBBBBBBBBBBBBBBBBBBBBBBBBBBBBBBBBBBBBBBBBBBBBBBBBBBBBBBBBBBBBBBBBBBBBBBBBBBB!BBBBBBBBBBBBBBBBBBBBBBBBBBBBBBBBBBBBBBBBBBBBBBBB----------------------BBBBBBBB##
B------------------------------------------------------BB--BBBBBB--BBBB------BBBB----------------------------------------------------------------------------------------pP
B------------------------------------------------------BB--BBBBBB--BBBB--g---BBBB------------------------------------------------------------DDD------------UUU----------pP
B-----------------------------------------cccc-------BB--------BB---B----BB----------cccccc------------------------------------------------------------------------------pP
B----------------------------------------------------BB--------BB---B----BB----------------------------------------------------------------------------------------------pP
B---------------------------------------B-BBBB-*-----BB--------BB---B----BB----------BBBBBB------------------------------------------------------------------------------pP
B-----------------------------O---------BcB--BcB-----BB----ccccBB---BcM--BO---g------BBBBBB--------------------g----------------------------------BBBBBm---------------)HpP
B---------M????--------####-------------BBB--BBB-----BBBB--BBBBBB---BBB--BB--BBBB------------------------g----[]-------------------------###--------------------------->hpP
B--------------------########---##---------------------BB-------------------gg--------------------------[]----pP-----g-----BB-----------g###-DDD------------UUU--BBBBBBBBBB
B------------------##########---####-------------------BB-----------------------------------------------pP----pP----[]-----BB---------g#####---------------------BBBBBBBBBB
B-------------gg-############g--####-------gg---------g------g--g--------------------------------g-gg---eE----eE--g-eE-----BB---------######---------g-----------BBBBBBBBBB
#################################################################################---#####################################--##--############-------########-------##########
