------------------------------------------------------------------------------------------------------------------------------------------------------------------------------------
------------------------------------------------------------------------------------------------------------------------------------------------------------------------------------
--------------------------------cc--------------------------------------------------------------------------------------------------------------------------------------------------
------------------------------------g--g---------------------------------------------------------------------------------------------------------------------------------|----------
---------------------gccc----------TTTTTTT-------------cccc----------g------------------cc--cc---------------------------------------------------------------------------|----------
---------------------TTTTT-----------------------------TTTT----------g--g-------cc---------------------------g-----cc--------------------##--------------------##--------|----------
---------------------------------------------cc------------------------TTTTTT------------------------g---------------------TTT-----------##-------------------###--------|----------
---------------------------------------------------------------------------------------------------TTTTTTTT----------------------------####------------------####--------|----------
------------------------------TTTTT----------------------------------------------TTT---------------------------------------------------####-----------------#####--------|----------
----R--------------TTTTTTTT--------------------------------------TTT---------------------TTT-------------------TTTT--TTTT------------######----------------######--------|-----XXX--
----R---------------------------------------------TTTT?------------------------------------------------------------------------------######---------------#######--------|-----XXX--
----------------------------c----------------------------------------------------------------TTTT------------------------------------######-----------[]-########--------|----XXxXX-
-------------TTTT----------TTT------------------------------------------------------------------------------ccc------------------g---######--------#--eE#########--------#----XXxXX-
###########----------------------------------####-----#####-#####-------------------------------------------###-------------########################################################
